+++++++++++++++
|       |     |
|-----  |     |
|    |        |
|    |     ---|
|    ----     |
|       |     |
|             |
|   ----------|
|             |
|--------     |
|             |
|    -------- |
|            O|
+++++++++++++++
