+++++++++++++++
|       |#    |
|-----  |     |
|    |        |
| |  |     ---|
| |  ----     |
| -     |     |
| #|          |
|  |----------|
|             |
|--------     |
| #           |
|    ---------|
|            O|
+++++++++++++++
