+++++++++++++++
|       |     |
|-----  |#    |
|    |       #|
| |  |     ---|
| |  ----     |
| -     |     |
|  |          |
|  |----------|
|    #        |
|--------     |
|             |
|    ---------|
|            O|
+++++++++++++++
