+++++++++++++++
|       |     |
|-----  |     |
|    |        |
| |  |     ---|
| |  ----     |
| -     |     |
|  |          |
|  |----------|
|      #      |
|--------  #  |
| #           |
|    ---------|
|            O|
+++++++++++++++
