+++++++++++++++
|      #|     |
|-----  |     |
|    |        |
| |  |     ---|
| |  ----     |
| -    #|     |
|  |          |
|  |----------|
|             |
|--------     |
|            #|
|    ---------|
|            O|
+++++++++++++++
