+++++++++++++++
|       |   # |
|-----  |     |
|    |        |
| |  |     ---|
| |  ----   # |
| -     |     |
|  |          |
|  |----------|
|           # |
|--------     |
|             |
|    ---------|
|            O|
+++++++++++++++
