+++++++++++++++
|       |     |
|-----  |     |
| #  |        |
| |  |     ---|
| |  ----     |
| -     |#    |
|  |#         |
|  |----------|
|             |
|--------     |
|             |
|    ---------|
|            O|
+++++++++++++++
