+++++++++++++++
|       |     |
|-----  |     |
|    |        |
| |  |     ---|
|#|  ----     |
| -     |     |
|  |          |
|  |----------|
|            #|
|--------     |
|#            |
|    ---------|
|            O|
+++++++++++++++
